111111111111111111111111111111111111111111111111111
100000000000000000000000000000000000000000000111111
111011111011111111101111111111111111110111111111111
100011000011000000001000000000000000000100000011111
101011011101011111101011111101111111110101111111111
101011000000011000001000000001000000000100000011111
101011011111111011101111111101111111110111111111111
101000000000000011101000000001000000000000000011111
101111111111111110001111111111111111110111111111111
100000000000000000001000000000000000000100000011111
111111111111111111101111111111111111110111111111111
100000000000000000001000000000000000000100000011111
101111111011111111101111111101111111110111111111111
100000000000000000001000000001000000000100000011111
101111111011111111101111111101111111110111111111111
100000000000000000001000000000000000000100000011111
101111111011111111101111111101111111110111111111111
100000000000000000001000000001000000000100000011111
101111111011111111101111111101111111110111111111111
10000000000000000E001000000000000000000100000011111
111111111111111111101111111111111111110111111111111
1P0000000000000000000000000000000000000000000011111
111011111011111111101111111111111111110111111111111
100011000011000000001000000C00000000000100000011111
101011011101011111101011111101111111110111111111111
111111111111111111111111111111111111111111111111111
