11111111111111111111111111111111111111111111111111111111111111111111111111111111111111111
10000000000000000000000000000000000000000000011111111111111111111111111111111111111111111
11101111101111111110111111111111111111011111111111111111111111111111111111111111111111111
10001100001100000000100000000000000000010000001111111111111111111111111111111111111111111
10101101110101111110101111110111111111010111111111111111111111111111111111111111111111111
10101100000001100000100000000100000000010000001111111111111111111111111111111111111111111
10101101111111101110111111110111111111011111111111111111111111111111111111111111111111111
10100000000000001110100000000100000000000000001111111111111111111111111111111111111111111
10111111111111111000111111111111111111011111111111111111111111111111111111111111111111111
10000000000000000000100000000000000000010000001111111111111111111111111111111111111111111
11111111111111111110111111111111111111011111111111111111111111111111111111111111111111111
10000000000000000000100000000000000000010000001111111111111111111111111111111111111111111
10111111101111111110111111110111111111011111111111111111111111111111111111111111111111111
10000000000000000000100000000100000000010000001111111111111111111111111111111111111111111
10111111101111111110111111110111111111011111111111111111111111111111111111111111111111111
10000000000000000000100000000000000000010000001111111111111111111111111111111111111111111
10111111101111111110111111110111111111011111111111111111111111111111111111111111111111111
10000000000000000000100000000100000000010000001111111111111111111111111111111111111111111
10111111101111111110111111110111111111011111111111111111111111111111111111111111111111111
10000000000000000E00100000000000000000010000001111111111111111111111111111111111111111111
11111111111111111110111111111111111111011111111111111111111111111111111111111111111111111
1P000000000000000000000000000000000000000000001111111111111111111111111111111111111111111
11101111101111111110111111111111111111011111111111111111111111111111111111111111111111111
100011000011000000001000000C0000000000010000001111111111111111111111111111111111111111111
10101101110101111110101111110111111111011111111111111111111111111111111111111111111111111
11111111111111111111111111111111111111111111111111111111111111111111111111111111111111111
11111111111111111111111111111111111111111111111111111111111111111111111111111111111111111